101101S11110110
010011000001001
01010B011101010
00000101a101001
111111000101101
111111111100001
000100001111010
010101101100001
010101001101101
110101011101001
G000010000g1010
011111110111001
010000101000101
01011011001b101
00010010E1100A1
